#
# This is a HexoNavi level file.
#
# The format of each row is: a b kind,
# blank lines and comments are ignored,
# the order of lines doesn't matter.
#

 3  2   start   #the avatar starts here
 0  3   goal    #...and should go there

                #lines with three numbers are fields
      #if kind == 0, the field is free
-3  7   1       #all other kinds are obstacles
-3  8   1
-2  5   1
-2  6   1
-2  7   1
-2  8   1
-1  3   1
-1  4   1
-1  5   1
-1  6   1
-1  7   1
-1  8   1
 0  1   1
 0  2   1
 0  3   0
 0  4   1
 0  5   1
 0  6   1
 0  7   1
 0  8   1
 1  0   1
 1  1   1
 1  2   1
 1  3   0
 1  4   0
 1  5   0
 1  6   1
 1  7   1
 1  8   1
 2  0   1
 2  1   1
 2  2   1
 2  3   1
 2  4   1
 2  5   0
 2  6   0
 2  7   1
 2  8   1
 3  0   1
 3  1   1
 3  2   0
 3  3   0
 3  4   1
 3  5   1
 3  6   0
 3  7   1
 3  8   1
 4  8   1
 4  0   1
 4  1   1
 4  2   1
 4  3   0
 4  4   1
 4  5   1
 4  6   0
 4  7   1
 4  8   1
 5  0   1
 5  1   1
 5  2   0
 5  3   1
 5  4   1
 5  5   0
 5  6   1
 5  7   1
 5  8   1
 6  0   1
 6  1   0
 6  2   1
 6  3   0
 6  4   0
 6  5   1
 6  6   1
 7  0   1
 7  1   0
 7  2   0
 7  3   1
 7  4   1
 8  0   1
 8  1   1
 8  2   1
 9  0   1