#
# This is a HexoNavi level file.
#
# The format of each row is: a b kind,
# blank lines and comments are ignored,
# the order of lines doesn't matter.
#

 1  1   start   #the avatar starts here
 1  7   goal    #...and should go there

-4  8   1       #lines with three numbers are fields
-3  6   1       #if kind == 0, the field is free
-3  7   1       #all other kinds are obstacles
-3  8   1
-2  4   1
-2  5   1
-2  6   1
-2  7   1
-2  8   1
-1  2   1
-1  3   1
-1  4   0
-1  5   0
-1  6   1
-1  7   1
-1  8   1
 0  0   1
 0  1   1
 0  2   1
 0  3   0
 0  4   1
 0  5   0
 0  6   1
 0  7   1
 0  8   1
 1  0   1
 1  1   0
 1  2   1
 1  3   0
 1  4   1
 1  5   0
 1  6   1
 1  7   0
 1  8   1
 2  0   1
 2  1   0
 2  2   0
 2  3   1
 2  4   0
 2  5   1
 2  6   1
 2  7   0
 2  8   1
 3  0   1
 3  1   1
 3  2   1
 3  3   1
 3  4   0
 3  5   1
 3  6   1
 3  7   0
 3  8   1
 4  8   1
 4  0   1
 4  1   1
 4  2   0
 4  3   0
 4  4   1
 4  5   0
 4  6   0
 4  7   1
 4  8   1
 5  0   1
 5  1   0
 5  2   1
 5  3   1
 5  4   0
 5  5   1
 5  6   1
 5  7   1
 6  0   1
 6  1   0
 6  2   0
 6  3   0
 6  4   1
 6  5   1
 7  0   1
 7  1   1
 7  2   1
 7  3   1
 8  0   1
 8  1   1
